++++++++++++++++++++++
+         +          +
+ +++ +++ + ++++ +++ +
+ +   +   +    +    +
+ + +++ +++++++ + ++++
+ +   +     +      + +
+ + +++++ + + +++++ + +
+ +     + + + +    + +
+ +++++ + + + + ++ + +
+       +   + +  + + +
+++++++++ + + + ++ + +
+         +   +    + +
+ +++++++ + ++++++++ +
+ S     + +        + +
+ + +++ + +++++++++ + +
+ +   + +          + +
+ +++ + +++++++++++ + +
+     +              +
+ ++++++++++++++++++ +
+                    +
++++++++++++++++++++++