+++++++++
+       +
+ +++++ +
+ + S + +
+ +   + +
+ +++ + +
+     + +
+++++++++