++++++++++++++++++++++
+ S                 +
+ +++++++++++++++++ +
+ +               + +
+ + ++++++++++++ + +
+ + +           + + +
+ + + +++++++ + + + +
+ + + +     + + + + +
+ + + + +++ + + + + +
+ + + + + + + + + + +
+ + + + + + + + + + +
+ + + + + + + + + + +
+ + + + + + + + + + +
+ + + + + + + + + + +
+ + + + + + + + + + +
+ + + + + + + + + + +
+ + + + + + + + + + +
+ + + + + + + + + + +
+ + + + + + + + + + +
+ + + + + + + + + + +
+ + + + + + + + + + +
++++++++++++++++++++++