[ ['+','+','+','+','+','+','+','+','+','+','+','+'],
 ['+','S','+',' ',' ','+','+','+','+','+',' ','+'],
 ['+',' ','+',' ',' ',' ',' ',' ',' ',' ',' ','+'],
 ['+',' ',' ',' ','+','+','+','+','+','+',' ','+'],
 ['+','+','+',' ','+','+',' ',' ',' ','+','+','+'],
 ['+',' ',' ',' ',' ',' ','+','+','+',' ',' ','+'],
 ['+','+','+','+','+','+','+','+','+','+',' ','+']] 

