[ ['+','+','+','+',...,'+','+','+','+','+','+','+'],
 ['+',' ','+',' ',...,'+','+','+','+','+',' ','+'],
 ['+',' ','+',' ',...,' ',' ',' ',' ',' ',' ','+'],
 ['+',' ',' ',' ',...,'+','+','+','+','+',' ','+'],
 ['+','+','+',' ',...,'+',' ',' ',' ','+','+','+'],
 ['+',' ',' ',' ',...,' ','+','+','+',' ',' ','+'],
 ['+','+','+','+',...,'+','+','+','+','+',' ','+']] 
